1 1 1 1 1 1 1 1 1 1 1 1 1 1 1 1 1 1 1 1 1 1 1 1 1 1 1 1 1 1 1 1 1 1 1 1 1 1 1 1 1 1 1 1 1 1 1 1 1 1
1 14 15 15 15 15 15 15 15 15 15 15 15 15 15 15 15 16 17 3 3 3 3 3 3 3 3 3 3 3 3 3 3 3 3 3 3 3 3 3 3 3 3 3 3 3 3 3 3 1
1 2 2 2 2 2 2 2 2 2 2 2 2 2 2 2 2 2 19 3 3 3 3 3 3 3 3 3 3 3 3 3 3 3 3 3 3 3 3 3 3 3 3 3 3 3 3 3 3 1
1 2 2 2 2 2 2 2 2 2 2 2 2 2 2 2 2 2 22 3 5 37 37 37 37 37 38 34 33 34 33 34 33 34 33 34 33 34 33 3 3 3 3 3 3 3 3 3 3 1
1 2 2 2 4 2 2 2 2 2 2 2 2 2 2 2 2 2 22 3 8 9 13 3 3 3 33 34 33 34 33 32 33 34 33 34 33 34 33 34 3 3 3 3 3 3 3 3 3 1
1 2 2 2 2 2 2 2 2 2 2 2 2 2 2 2 2 2 22 3 8 10 3 3 3 3 34 33 34 33 34 33 34 33 34 33 34 33 32 33 34 3 3 3 3 3 3 3 3 1
1 2 2 2 2 2 2 2 2 2 2 2 2 2 2 2 2 2 22 3 8 10 3 3 3 3 3 34 32 34 33 34 33 34 33 34 33 34 33 34 33 3 3 3 3 3 3 3 3 1
1 2 2 2 2 2 2 2 2 2 2 2 2 2 2 2 2 2 22 3 8 9 3 3 3 3 3 3 3 3 3 3 3 3 3 3 3 3 3 3 3 3 3 3 3 3 3 3 3 3 1
1 2 2 2 2 2 2 2 2 2 2 2 2 2 2 2 2 2 22 3 8 9 10 14 15 15 15 15 15 15 15 15 15 15 15 15 15 15 15 15 15 15 15 15 15 15 15 15 17 1
1 2 2 2 2 2 2 2 2 2 2 2 2 2 2 2 2 2 22 3 8 9 10 18 2 2 2 2 2 2 2 2 2 2 2 2 2 2 2 2 2 2 2 2 2 2 2 2 22 1
1 2 2 2 2 2 2 2 2 2 2 2 2 2 2 2 2 2 22 3 8 9 10 27 2 2 2 2 2 2 2 2 2 2 2 2 2 2 2 2 2 2 2 2 2 2 2 2 22 1
1 2 2 2 2 2 2 2 2 2 2 2 2 2 2 2 2 2 22 3 8 9 10 27 2 2 2 2 2 2 2 2 2 2 2 2 2 2 2 2 2 2 2 2 2 2 2 2 22 1
1 2 2 2 2 2 2 2 2 2 2 2 2 2 2 2 2 2 22 3 8 9 10 20 21 2 2 2 2 2 2 2 2 2 2 2 2 2 2 2 2 2 2 2 2 2 2 2 22 1
1 2 2 2 2 2 2 2 2 2 2 2 2 2 2 2 2 2 22 3 8 9 10 3 24 25 25 25 25 25 25 25 25 25 25 25 25 25 25 25 25 25 25 25 25 25 25 25 26 1
1 2 2 2 2 2 2 2 2 2 2 2 2 2 2 2 2 2 22 3 8 9 10 3 3 3 3 3 3 3 3 3 3 3 3 3 3 3 3 3 3 3 3 3 3 3 3 3 3 1
1 2 2 2 2 2 2 2 2 2 2 2 2 2 2 2 2 2 22 3 8 9 10 3 3 3 3 3 3 3 3 3 3 3 3 3 3 3 3 3 3 3 3 3 3 3 3 3 3 1
1 2 2 2 2 2 2 2 2 2 2 2 2 2 2 2 2 2 22 3 8 9 10 3 3 3 3 33 34 33 34 33 34 33 34 33 34 33 34 33 34 33 34 33 34 33 34 33 34 1
1 2 2 2 2 2 2 2 2 2 2 2 2 2 2 2 2 2 22 3 8 9 10 3 3 33 34 33 34 33 34 33 34 33 34 33 34 33 34 33 32 33 34 33 34 33 3 3 3 1
1 2 2 2 2 2 2 2 2 2 2 2 2 2 2 2 2 2 22 3 8 9 10 3 3 33 34 33 35 33 34 32 34 33 34 33 34 33 34 33 34 33 33 3 3 3 3 3 3 1
1 2 2 2 2 2 2 2 2 2 2 2 2 2 2 2 2 2 22 3 8 9 9 37 37 37 37 37 38 33 34 33 34 33 34 33 34 33 34 33 34 33 34 33 3 3 3 3 3 1
1 2 2 2 2 2 2 2 2 2 2 2 2 2 2 2 2 2 22 3 8 9 10 33 34 33 34 33 34 33 34 33 34 33 34 33 34 33 34 33 34 33 34 33 3 3 3 3 3 1
1 2 2 2 2 2 2 2 2 2 2 2 2 2 2 2 2 2 22 3 8 9 10 3 3 3 3 33 34 33 34 33 34 33 34 33 34 39 33 34 33 34 33 34 33 3 3 3 3 1
1 2 2 2 2 2 2 2 2 2 2 2 2 2 2 2 2 2 22 3 8 9 10 3 3 3 3 33 32 33 34 33 34 33 34 33 34 40 33 33 34 35 34 33 34 3 3 3 3 1
1 2 2 2 2 2 2 2 2 2 2 2 2 2 2 2 28 25 26 3 8 9 10 3 3 3 33 34 33 32 33 34 33 34 33 34 33 40 34 33 34 33 34 33 34 3 3 3 3 1
1 2 2 2 2 2 2 2 2 2 2 2 2 2 2 2 29 3 3 3 8 9 10 3 3 3 3 33 33 34 33 33 34 33 33 34 33 41 33 34 33 33 35 33 33 3 3 3 3 1
1 2 2 2 2 2 2 2 2 2 2 2 2 2 2 2 29 3 3 3 8 9 10 3 3 3 3 34 34 33 34 34 33 34 34 14 15 16 17 33 34 34 33 34 34 33 3 3 3 1
1 2 2 2 2 2 2 2 2 2 2 2 2 2 2 2 29 3 3 3 8 9 10 3 3 3 3 3 33 33 34 33 33 34 33 18 2 2 19 33 34 33 33 34 3 3 3 3 3 1
1 2 2 2 2 2 2 2 2 2 2 2 2 2 2 2 29 3 3 3 8 9 9 37 37 37 37 37 6 37 37 37 37 37 38 20 21 2 22 33 34 33 33 34 3 3 3 3 3 1
1 2 2 2 2 2 2 2 2 2 2 2 2 2 2 2 29 3 3 3 8 9 10 3 3 3 3 3 40 33 34 33 34 33 34 23 24 25 26 33 34 33 33 3 3 3 3 3 3 1
1 2 2 2 2 2 2 2 2 2 2 2 2 2 2 2 29 3 3 3 8 9 10 3 3 3 3 3 40 33 34 33 34 32 33 34 33 39 32 34 33 34 34 33 33 34 3 3 3 1
1 2 2 2 2 2 2 2 2 2 2 2 2 2 2 2 29 3 3 3 8 9 10 3 3 3 3 3 40 33 34 33 32 33 34 33 34 40 33 34 33 34 34 34 32 33 3 3 3 1
1 2 2 2 2 2 2 2 2 2 2 2 2 2 2 2 29 3 3 3 8 9 10 3 3 3 3 3 40 34 33 34 34 33 33 34 33 40 33 33 34 34 33 34 33 34 3 3 3 1
1 2 2 2 2 2 2 2 2 2 2 2 2 2 2 2 29 3 3 3 8 9 10 3 3 3 3 3 40 33 34 32 34 33 34 33 34 41 34 33 34 33 34 34 33 34 3 3 3 1
1 2 2 2 2 2 2 2 2 2 2 2 2 2 2 2 29 3 3 3 8 9 10 3 3 3 3 3 40 33 34 33 33 34 33 34 33 33 34 33 34 33 34 35 34 33 3 3 3 1
1 2 2 2 2 2 2 2 2 2 2 2 2 2 2 2 29 3 3 3 8 9 10 3 3 3 3 3 40 33 34 33 34 34 33 34 33 34 33 33 34 33 34 33 34 33 3 3 3 1
1 2 2 2 2 2 2 2 2 2 2 2 2 2 2 2 29 3 3 3 8 9 10 3 3 3 3 3 40 33 34 33 34 33 33 34 33 34 33 33 34 33 34 33 34 3 3 3 3 1
1 2 2 2 2 2 2 2 2 2 2 2 2 2 2 2 29 3 3 3 8 9 10 3 3 3 3 3 40 32 34 33 33 34 33 34 33 34 33 34 33 34 33 34 33 34 3 3 3 1
1 2 2 2 2 2 2 2 2 2 2 2 2 2 2 2 29 3 3 3 8 9 10 3 3 3 3 3 11 37 37 37 37 37 7 33 34 33 33 34 33 34 33 34 33 34 3 3 3 1
1 2 2 2 2 2 2 2 2 2 2 2 2 2 2 2 29 3 3 3 8 9 10 3 3 3 3 3 3 3 3 3 3 3 40 33 34 34 34 33 33 33 42 43 44 45 3 3 3 1
1 2 2 2 2 2 2 2 2 2 2 2 2 2 2 2 29 3 3 3 8 9 10 3 3 3 3 3 3 3 3 3 3 3 40 33 34 33 33 34 33 34 46 47 48 49 3 3 3 1
1 2 2 2 2 2 2 2 2 2 2 2 2 2 2 2 29 3 3 3 8 9 10 3 3 3 3 3 3 3 3 34 33 33 41 33 34 33 34 33 34 34 50 51 52 53 35 3 3 1
1 2 2 2 2 2 2 2 2 2 2 2 2 2 2 2 29 3 3 3 8 9 10 3 3 3 3 3 3 33 34 34 33 32 34 33 33 33 34 33 33 34 33 33 32 33 34 3 3 1
1 2 2 2 2 2 2 2 2 2 2 2 2 2 2 2 29 3 3 3 8 9 10 3 3 3 3 3 3 34 33 33 34 33 33 33 34 34 34 34 33 33 34 33 34 33 34 3 3 1
1 2 2 2 2 2 2 2 2 2 2 2 2 2 2 2 29 3 3 3 8 9 10 3 3 3 3 3 3 33 34 34 33 35 33 34 34 34 33 33 34 32 33 34 3 3 3 3 3 1
1 2 2 2 2 2 2 2 2 2 2 2 2 2 2 2 29 3 3 3 8 9 10 3 3 3 3 3 33 34 33 33 34 33 34 33 34 33 34 33 34 34 33 34 3 3 3 3 3 1
1 2 2 2 2 2 2 2 2 2 2 2 2 2 2 2 29 3 3 3 3 3 3 3 3 3 3 3 3 3 3 3 3 3 3 3 3 3 3 3 3 3 3 3 3 3 3 3 3 1
1 2 2 2 2 2 2 2 2 2 2 2 2 2 2 2 30 31 31 31 31 31 31 31 31 31 31 31 31 31 31 31 31 31 31 31 31 31 31 31 31 31 31 31 31 31 31 31 31 1
1 2 2 2 2 2 2 2 2 2 2 2 2 2 2 2 2 2 2 2 2 2 2 2 2 2 2 2 2 2 2 2 2 2 2 2 2 2 2 2 2 2 2 2 2 2 2 2 2 1
1 2 2 2 2 2 2 2 2 2 2 2 2 2 2 2 2 2 2 2 2 2 2 2 2 2 2 2 2 2 2 2 2 2 2 2 2 2 2 2 2 2 2 2 2 2 2 2 2 1
1 1 1 1 1 1 1 1 1 1 1 1 1 1 1 1 1 1 1 1 1 1 1 1 1 1 1 1 1 1 1 1 1 1 1 1 1 1 1 1 1 1 1 1 1 1 1 1 1 1